222222222222222222222
200011002212200110002
202212201111102212202
202000212212212000202
212212210222012212212
211101110020011101112
220212020222020212022
220212020222020212022
211101110020011101112
212212210222012212212
202000212212212000202
202212201111102212202
200011002212200110002
222222222222222222222
